2222222222222222222
2111111111111111112
2110111011101110112
2200020002000200022
2110111011101110112
2111111111111111112
2221222122212221222
2221222122212221222
2221222122212221222
2111111111111111112
2110111011101110112
2200020002000200022
2110111011101110112
2111111111111111112
2222222222222222222